WWWWWWWWWWWWWWWWWWWWWWWWWWWWWWWWWWWWWW
WEEEEEEEWEEEEEEEEEEEEEEEEEEEEEEEEEEEEW
WEEEEEEEWEEEEEEEEEEEEEEEEEEEEEEEEEEEEW
WEEEEEEEWEEEEEEWEEEEEWWWWWWWWWWEEEEEEW
WEEEEEEEEEEEEEEWEEEEAEEEEEEEEEWEEEEEEW
WEEEEEEEEEEEEEEWEEEEEEEEEEEEEEWEEEEEEW
WEEEWWWWWWWWWWWWWWWWWWEEEEEEEEWEEEEEEW
WEEEEEEEEEEEEEEEEEEEEEWEEEEEEEEEEEEEEW
WEEEEEEEEEEEEEEEEEEEEEWEEEEEEEEEEEEEEW
WEEEEEEEEWEEEEEEEEEEEEWEEEWWWWWWWWWWWW
WEEEEEEEEWEEEEWEEEEEEEWEEEEEEEEEEEEEEW
WEEEEEEEEWEEEEWEEEEEEEEWWWWWWWWEEEEEEW
WEEEEEEEEW<EEEWEEEEEEEEWEEEEEEWEEEEEEW
WWWWWWWWWWWWEEWEEEEEEEEWEEEEEEWEEEEEEW
WWWEEEEEEEEEEEWEEEEEEEEWEEEWEEWEEEEEEW
WEEEEEEEEEEEEEEEEEEEEEEWEEEWEEWEEEEEEW
WEEEEWWWEEEEEEEEWWWWEEEWEEEWEEEEEEEEEW
WEEEWEEEEEEEEEEEEEEEEEEWEEEWEEEEEEEEEW
WEEEWEEEEEEEEEEEEEEEEEWEEEEWEEEEEEEEEW
WEEEWWWWWWWWWWWWWEEEEWEEEEEEEEEEEEEEEW
WEEEEEEEEEWEEEEEWEEEEWEEEWEEEEEEEEEEEW
WEEEEEEEEEWEENEEWWWWWEEEEWWWWWWWWWWWWW
WEEEEEEEEEWEEFEEEEEEEEEEEE<EEEEEEEEEEW
WEEEEEEEEWEEEEEEEEEEEEEEEEEEEEEEEEEDDW
WWWWWWWWWWWWWWWWWWWWWWWWWWWWWWWWWWWWWW


