WWWWWWWWWWWWWWWWWWWWWWWWWWWWWWWWWWWWWW
WEEEEEEEEEEEEEEEEEEEEEEEEEEEEEEEEEEEEW
WEEEEEEEEEEEEEEEEEEEEEEEEEEEEEEEEEEEEW
WEEEEEEEEEEEEEEEEEEEEEEEEEEEEEEEEEEEEW
WEEEEEEEEEEEEEEEEEEEEEEEEEEEEEEEEEEEEW
WEEEEEEEEEEEEEEEEEEEEEEEEEEEEEEEEEEEEW
WEEEEEEEEEEEEEEEEEEEEEEEEEEEEEEEEEEEEW
WEEEEEEEEEEEEEEEEEEEEEEEEEEEEEEEEEEEEW
WEEEEEEEEEEEEEEEEEEEEEEEEEEEEEEEEEEEEW
WEEEEEEEEEEEEEEEEEEEEEEEEEEEEEEEEEEEEW
WEEEEEEEEEEEEEEEEEEEEEEEEEEEEEEEEEEEEW
WEEEEEEEEEEEEEEEEEEEEEEEEEEEEEEEEEEEEW
FEEEEEEEEEEEEEEEEEEEEEEEEEEEEEEEEEEEEW
WEEEEEEEEEEEEEEEEEEEEEEEEEEEEEEEEEEEEW
WEEEEEEEEEEEEEEEEEEEEEEEEEEEEEEEEEEEEW
WEEEEEEEEEEEEEEEEEEEEEEWEEEEEEEEEEEEEW
WEEEEEEEEEEEEEEEEEEEEEEWEEEEEEEEEEEEEW
WEEEEEEEEEEEEEEEEEEEEEEWEEEEEEEEEEEEEW
WEEEEEEEEEEEEEEEEEEEEEWEEEEEEEEEEEEEEW
WEEEEEEEEEWWWWWWWEEEEWEEEEEEEEEEEEEEEW
WEEEEEEEEEWEEEEEWEEEEWEEEWEEEEEEEEEEEW
WEEEEEEEEEWEEEEEWWWWWEEEEWWWWWWWWWWWWW
WEEEEEEEEEWEEEEEEEEEEEEEEEEEEEEEEEEEEW
WEEEEEEEEEWEEEEEEEEEEEEEEEEEEEEEEEEEEW
WWWWWWWWWWWWWWWWWWWWWWWWWWWWWWWWWWWWWW


