WWWWWWWWWWWWWWWWWWWWWWWWWWWWWWWWWWWWWW
WNWWWEEWWEEEEEEEEEEEEEEEEEEEEEEEEWWWWW
WWWWEEEWWEEEEEEEEEEEEEEEEEEEEEEEEEWWWW
WWWEEEEWWEEEEEEWWEEEEWWWWWWWWWWWEEEWWW
WWEEEEEEEvEEEEEWWEEEEEEEEEEEEEWWEEEEWW
WEEEEEEEEEEEEEEWWEEEEEEEE<EEEEWWEEEEEW
WEEEWWWWWWWWWWWWWWWWWWWWEEEEEEWWEEEEWW
WEEEWWWWWWWWWWWWWWWWWWWWEEEEEEEEEEEWWW
WEEEEEEEEEEEEEEEEEEEEEWWEEEWWWWWWWWWWW
WEEEEEEEWWEEEEEEEEEEEEWWEEWWWWWWWWWWWW
WEEEEEEEWWEEEEWWEEEEEEWWEEEEEEEEEEWWWW
WEEEAEEEWWEEEEWWEEEEEEWWWWWWWWWEEEEWWW
WEEEEEEEWW<EEEWWEEEEEEWWEEEEEEWEEEEEWW
WWWWWWWWWWWWEEWWEEEEEEWWEEEEEEWEEEEEEW
WWWEEEEEEEEEEEWWWEEEEEWWEEEWEEWEEEEEEW
WEEEEE<EEEEEEEEWWWWWEEWWEEEWEEWvEEEEEW
WEEEWWWWEEEEEEEEWWWWEEWWEEEWEEEEEEEEEW
WEEEEEEEEEEEEEEEEEEEEEWWEEEWEEEEEEEEWW
WEEEEEEEEEEEEEEEEEEEEWWEEEEWEEEEEEWWWE
WEEEEEWWWWWWWWWWWEEEWWEEEEEEEEEEEWWWEE
WEEEEWWWWWWWEEENWEEEWWEEEWWWWWWWWWWWEE
WEEEWWWWPPWWEEECWWeWWWEEEWWWWWWWWWWWWW
WWFWWWWWEEWWEWWWWWWWWWEEEE<EEEEEEEEEDW
WWWWWWWWEEEEEEEEEEEEEEEEEEEEEEEEEEEEDW
WWWWWWWWWWWWWWWWWWWWWWWWWWWWWWWWWWWWWW


