WWWWWWWWWWWWWWWWWWWWWWWWWWWWWWWWWWWWWW
WEEEEEEEEEEEEEEEEEEEEEEEEEEEEEEEEEEEEW
WEEEEEEEEEEEEEEEEEEEEEEEEEEEEEEEEEEEEW
WEEEEEEEEEEEEEEEEEEEEEEEEEEEEEEEEEEEEW
WEEEEEEEEEEEEEEEEEEEEEEEEEEEEEEEEEEEEW
WEEEEEEEEEEEEEEEEEEEEEEEEEEEEEEEEEEEEW
WEEEEEEEEEEEEEEEEEEEEEEEEEEEEEEEEEEEEW
WEEEEEEEEEEEEEEEEEEEEEEEEEEEEEEEEEEEEW
WEEEEEEEEEEEEEEEEEEEEEEEEEEEEEEEEEEEEW
WEEEEEEEEEEEEEEEEEEEEEEEEEEEEEEEEEEEEW
WEEEEEEEEEEEEEEEEEEEEEEEEEEEEEEEEEEEEW
WEEEEEEEEEEEEEEEEEEEEEEEEEEEEEEEEEEEEW
FEEEEEEEEEEEEEEEEEEEEEEEEEEEEEEEEEEEEW
WEEEEEEEEEEEEEEEEEEEEEEEEEEEEEEEEEEEEW
WEEEEEEEEEEEEEEEEEEEEEEEEEEEEEEEEEEEEW
WEEEEEEEEEEEEEEEEEEEEEEEEEEEEEEEEEEEEW
WEEEEEEEEEEEEEEEEEEEEEEEEEEEEEEEEEEEEW
WEEEEEEEEEEEEEEEEEEEEEEEEEEEEEEEEEEEEW
WEEEEEEEEEEEEEEEEEEEEEEEEEEEEEEEEEEEEW
WEEEEEEEEEEEEEEEEEEEEEEEEEEEEEEEEEEEEW
WEEEEEEEEEEEEEEEEEEEEEEEEEEEEEEEEEEEEW
WEEEEEEEEEEEEEEEEEEEEEEEEEEEEEEEEEEEEW
WEEEEEEEEEEEEEEEEEEEEEEEEEEEEEEEEEEEEW
WEEEEEEEEEEEEEEEEEEEEEEEEEEEEEEEEEEEEW
WWWWWWWWWWWWWWWWWWWWWWWWWWWWWWWWWWWWWW


