WWWWWWWWWWWWWWWWWWWWWWWWWWWWWWWWWWWWWW
WWWWWEEWWWWEEEEEEEEEEEEEEEEEEEEEEWWWWW
WWWWEEEWWWEEEEEEEEEEEEEEEEEEEEEEEEWWWW
WWWEEEEWWEEEEEEWWEEEEWWWWWWWWWWWEEEWWW
WWEEEEEEEvEEEEEWWEEE<EEEEEEEEEWWEEEEWW
WEEEEEEEEEEEEEEWWEEEEEEEEEEEEEWWEEEEEW
WEEEWWWWWWWWWWWWWWWWWWWWEEEEEEWWEEEEWW
WEEEWWWWWWWWWWWWWWWWWWWWEEE<EEEEEEEWWW
WEEEEEEEEEEEEEEEEEEEEEWWEEEWWWWWWWWWWW
WEEEvEEEWWEEEEEEEEEEEEWWEEWWWWWWWWWWWW
WEEEEEEEWWEEEEWWEEEEEEWWEEEEEEEEEEWWWW
WWEEEEEEWWEEEEWWEEEEvEWWWWWWWWWEEEEWWW
WWWEEEEEWW<EEEWWEEEEEEWWEEEEEEWEEEEEWW
WWWWWWWWWWWWEEWWEEEEEEWWEEEEEEWEEEEEEW
WWWEEEEEEEEEEEWWWEE>EEWWEEEWEEWEEEEEEW
WEEEEE<EEEEEEEEWWWWWEEWWEEEWEEWvEEEEEW
WEEEWWWWEEEEEEEEWWWWEEWWEEEWEEEEEEEEEW
WEEEEEEEEEEEEEEEEEEEEEWWEEEWEEEEEEEEWW
WEEEEEEEEWWWWWWWEEEEEWWEEEEEEEEEEEWWWW
WEEEEEEEWWWWWWWWWEEEWWEEEEWWWWWWWWWWWW
WEEEEEEWWWWWEEENWEEEWWEEEWWWWWWEEEWWWW
WEEEEWWWPPWWEEECWWeWWWEEEWWWWWEEWEEWWW
WWFWWWWWEEWWEWWWWWWWWWEEEWWWWEEWWWEDWE
WWWWWWWWEEEEEEEEEEEEEEEEEEEEEEECWEEDWE
WWWWWWWWWWWWWWWWWWWWWWWWWWWWWWWWWWWWWE


