WWWWWWWWWWWWWWWWWWWWWWWWWWWWWWWWWWWWWW
WFEEEEEDWEEEEEEEEEEEEEEEEEEEEEEEEWWWWW
WEEEEEECWEEEEEEEEEEEEEEEEE>EEEEEEEWWWW
WEEEEEWWWEEEEEEWWEEEEEEWWWWWWWWWEEEWWW
WEEEWWWWWEEEEEEWWEEEEEEWWWWWWWWWEEEEWW
WWEEEEEE>EEEEEEWWEEEEEEEEEEEEEWWEEEEEW
WWWEEEEEEEEEEEEWWWWWWWWWvEEEEEWWEEEEEW
WWEEEWWWWWWWEEEWWWWWWWWWEEEEEEWWEEEEEW
WEEEEEEEEEEEEE<EEEEEEEEEEEEEEEWWEEEEEW
WEEEEEEEEEEEEEWEEEEEEEEEEEEEEEE>EEEEEW
WWEEEEEEEWEEEEWWWWWWWWWWEEEEEEEEEEEEWW
WWWEEEEEEWAEEEWWEEPPEEWWWWWWWWWEEEEWWW
WWWWEEEEEWEEEEWWEEEEEEWWWWWWWWWEEEEWWW
WWWWWWWvEWEEEEWWEEEEEEEEEEEEEWWEEEEEWW
WWWWWEEEEEEEEEWWEEEEEEWWEEWWEWWvEEEEEW
WWWEEEEEEE<EEEWWWWWWWWWWEEWWEWWEEEEEEW
WWEEWWWWEEEEEEWWWWWWWWWWEEWWEEEEEEEEEW
WEEEWWWWWEEEEEEEEEEEEEWWEEWWEEEEWEEEEW
WEEEWWWWWWEEEEEE>EEEEWWEEEEEEEEEWEEEWW
WEEEWWWWWWEEWWWWWEEEEWWEEEEEEEEEEEEWWW
WWEEEENWWWEEEEWWWEEWWWWEEWWWWEEEEEWWWW
WWWEEECWWWEEEEEWWEEWWWWEEWWWWEEEWWWWWW
WWWWWWWWWWWEEEEEEEEEEEEEEEEEEEE<EWWWWW
WWWWWWWWWWWWEEEEEEEEEEEEEEEEEEEEEEWWWW
WWWWWWWWWWWWWWWWWWWWWWWWWWWWWWWWWWWWWW
