WWWWWWWWWWWWWWWWWWWWWWWWWWWWWWWWWWWWWW
WEEEEEEEWEEEEEEEEEEEEEEEEEEEEEEEEEEEEW
WEEEEEEEWEEEEEEEEEEEEEEEEEEEEEEEEEEEEW
WEEEEEEEWEEEEEEWEEEEEWWWWWWWWWWEEEEEEW
WEEEEEEEEEEEEEEWEEEEEEEEEEEEEEWEEEEEEW
WEEEEEEEEEEEEEEWEEEEEEAEEEEEEEWEEEEEEW
WEEEWWWWWWWWWWWWWWWWWWEEEEEEEEWEEEEEEW
WEEEEEEEEEEEEEEEEEEEEEWEEEEEEEEEEEEEEW
WEEEEEEEEEEEEE<EEEEEEEWEEEEEEEEEEEEEEW
WEEEEEEEEWEEEEEEEEEEEEWEEEWWWWWWWWWWWW
WEEEEEEEEWEEEEWEEEEEEEWEEEEEEEEEEEEEEW
WEEEEEEEEWEEEEWEEEEEEEEWWWWWWWWEEEEEEW
WEEEEEEEEWEEEEWEEEEEEEEWEEEEEEWEEEEEEW
WWWWWWWWWWWWEEWEEEEEEEEWEEEEEEWEEEEEEW
WWWEEEEEEEEEEEWEEEEEEEEWEEEWEEWEEEEEEW
WEEEEEEEEEEEEEEEEEEEEEEWEEEWEEWEEEEEEW
WEEEEWWWEEEEEEEEWWWWEEEWEEEWEEEEEEEEEW
WEEEWEEEEEEEEEEEEEEEEEEWEEEWEEEEEEEEEW
WEEEWEEEEEEEEEEEEEEEEEWEEEEWEEEEEEEEEW
WEEEWWWWWWWWWWWWWEEEEWEEEEEEEEEEEEEEEW
WEEEEEEEEEWEEEEEWEEEEWEEEWEEEEEEEEEEEW
WEEEEEEEEEWEENEEWWWWWEEEEWWWWWWWWWWWWW
WEEEEEEEEEWEEFEEEEEEEEEEEEEEEEEEEE<EEW
WEEEEEEEEWEEEEEEEEEEEEEEEEEEEEEEEEEDDW
WWWWWWWWWWWWWWWWWWWWWWWWWWWWWWWWWWWWWW
