WWWWWWWWWWWWWWWWWWWWWWWWWWWWWWWWWWWWWW
WFEEEEEDWEEEEEEEEEEEEEEEEEEEEEEEEWWWWW
WEEEEEECWEEEEEEEEEEEEEEEEE>EEEEEEEWWWW
WEEeNEWWWEEEEEEWEEEEEEEWWWWWWWWWEEEWWW
WEEEWWWWWEEEEEEWEEEEEEEEEEEEEEEWEEEEWW
WEEEEEEE>EEEEEEWEEEEEEEEEEEEEEEWEEEEEW
WEEEEEEEEEEEEEEWWWWWWWWWvEEEEEEWEEEEEW
WEEEEWWWWWWWEEEEEEEEEEEWEEEEEEEWEEEEEW
WEEEEEEEEEEEEE<EEEEEEEEEEEEEEEEWEEEEEW
WEEEEEEEEEEEEEWEEEEEEEEEEEEEEEE>EEEEEW
WEEEEEEEEWEEEEWWWWWWWWWWEEEEEEEEEEEEEW
WEEEEEEEEWAEEEWEEEPPEEEWWWWWWWWEEEEEEW
WEEEEEEEEWEEEEWEEEEEEEEEEEEEEEWEEEEEEW
WWWWWWWvEWEEEEWEEEEEEEEEEEEEEEWEEEEEEW
WWWEEEEEEEEEEEWEEEEEEEEWEEEWEEWvEEEEEW
WEEEEEEEEEEEEEWWWWWWWWWWEEEWEEWEEEEEEW
WEEEWWWEEEEEEEEEEEEEEEEWEEEWEEEEEEEEEW
WEEEWEEEEEEEEEEEEEEEEEWWEEEWEEEEWEEEEW
WEEEWEEEEEEEEEEE>EEEEWWEEEEEEEEEWEEEEW
WEEEWWWWWWWWWWWWWEEEEWEEEEEEEEEEEEEEEW
WWEEEENWEEEEEEEEWEEEEWEEEWEEEEEEEEEEEW
WWWEEECWEEEEEEEEWEEWWWEEEWWWWEEEWWWWWW
WWWWWWWWWEEEEEEEEEEEEEEEEEEEEEEEEE<EEW
WWWWWWWWWWEEEEEEEEEEEEEEEEEEEEEEEEWWWW
WWWWWWWWWWWWWWWWWWWWWWWWWWWWWWWWWWWWWW
